111 1111111111
 111 1111111
11111  11011111
10101 111011
11111 11111
