NO ./textures/redbrick.xpm
SO ./textures/wood.xpm
WE ./textures/greystone.xpm
EA ./textures/bluestone.xpm

F 105,105,105
C 0,255,255

111111111111111111111111
100000000000000000000001
100000000000000000000001
100000000000000000000001
100000222220000303030001
100000200020000000000001
100000200020000300030001
100000200020000000000001
1000002202200X0303030001
100000000000000000000001
100000000000000000000001
100000000000000000000001
100000000000000X00000001
100000X00000000000000001
10000N000000000000000001
100000000000000000000001
14444444400000000X000001
140400004000000000000001
14000050400X000000000001
140400004000000000000001
140444444000000000X00001
140000000000000000000001
144444444000000000000001
111111111111111111111111